官方
拂风水畔-1
🟨3
🟨🟥🟨🟨🟨🟦🟩🟨🟦🟨
🟦🟦🟦🟦🟦🟦🟩🟨🟦🟨
🟨🟥🟦🟥🟥🟥🟩🟥🟦🟨
🟨🟥🟦🟥🟨🟨🟩🟥🟦🟨
🟨🟥🟦🟥🟨🟩🟩🟥🟦🟨
🟨🟨🟦🟨🟨🟩🟨🟥🟦🟨
🟨🟨🟦🟦🟦🟩🟦🟦🟦🟨
🟩🟩🟩🟩🟩🟩🟨🟥🟥🟥

官方
拂风水畔-2
🟦3
🟨🟥🟥🟦🟨🟨🟨🟨🟦🟨
🟩🟩🟩🟩🟩🟩🟩🟩🟩🟩
🟨🟥🟥🟦🟩🟩🟩🟩🟦🟨
🟨🟥🟥🟦🟨🟩🟩🟩🟦🟨
🟨🟥🟥🟦🟨🟨🟩🟩🟦🟨
🟨🟥🟥🟦🟨🟨🟨🟩🟦🟨
🟨🟥🟥🟦🟨🟨🟨🟨🟦🟨
🟨🟥🟥🟦🟨🟨🟨🟨🟦🟨

官方
拂风水畔-3
🟥4
🟨🟥🟦🟦🟨🟨🟨🟨🟨🟨
🟨🟥🟥🟨🟨🟨🟨🟨🟨🟨
🟨🟦🟨🟨🟦🟩🟩🟦🟦🟨
🟨🟦🟨🟨🟩🟨🟨🟨🟩🟨
🟨🟥🟨🟨🟦🟨🟨🟨🟩🟨
🟨🟩🟦🟦🟩🟨🟥🟥🟦🟨
🟨🟨🟨🟨🟨🟨🟥🟨🟨🟨
🟨🟨🟩🟩🟩🟥🟦🟨🟨🟨

官方
拂风水畔-4
🟩3
🟥🟥🟥🟥🟥🟦🟦🟦🟦🟦
🟥🟦🟦🟦🟥🟦🟩🟩🟩🟩
🟥🟦🟦🟦🟥🟦🟩🟦🟦🟩
🟥🟦🟨🟨🟨🟨🟨🟨🟨🟩
🟥🟥🟥🟥🟥🟦🟩🟩🟩🟩
🟦🟦🟨🟦🟦🟦🟦🟦🟨🟦
🟦🟦🟨🟦🟦🟦🟦🟦🟨🟦
🟦🟦🟨🟨🟨🟨🟨🟨🟨🟦
